########################
#        #            #
#        ####    o    #
#    o                #
#              e   ####
#                 #####
#    #######o     #####
#    e    o      #######
## ############ ########