########################
#        #            # 
#   o    ####    o    # 
#                     # 
#      o       e     # 
#    #######   ####### 
#           o          
##### ### ######  ######